TITLE:song0702
BPM:114
MEASURE:4/4
OFFSET:7.943
KSPEED:1
MATCHTIME:137
DANGCE:9.501

@showtime:18:26
@showtime:42:50

#PATSTART
#0011:110000
#0012:000000

#0021:010000
#0022:100000

#0031:200000
#0032:000000

#0041:000000
#0042:890000

#0051:110000
#0052:000000

#0061:000000
#0062:200000

#0071:801000
#0072:090000

#0081:089000
#0082:100000

#0091:890000
#0092:001000

#0101:000000
#0102:000000

#0111:010000
#0112:200000

#0121:000000
#0122:000000

#0131:091000
#0132:800000

#0141:000000
#0142:000000

#0151:101100
#0152:010000

#0161:000000
#0162:000000

#0171:109100
#0172:080000

#0181:000000
#0182:000000

#0191:000000
#0192:000000

#0201:000000
#0202:000000

#0211:000000
#0212:000000

#0221:000000
#0222:000000

#0231:000000
#0232:000000

#0241:000000
#0242:000000

#0251:000000
#0252:000000

#0261:000000
#0262:000000

#0271:101000
#0272:010000

#0281:000000
#0282:000000

#0291:089000
#0292:100000

#0301:000000
#0302:000000

#0311:801100
#0312:090000

#0321:000000
#0322:000000

#0331:011000
#0332:200000

#0341:000000
#0342:000000

#0351:000100
#0352:112000

#0361:000000
#0362:000000

#0371:111800
#0372:000090

#0381:000000
#0382:000000

#0391:091000
#0392:800100

#0401:000000
#0402:000000

#0411:100000
#0412:011000

#0421:000000
#0422:000000

#0431:000000
#0432:000000

#0441:000000
#0442:000000

#0451:000000
#0452:000000

#0461:000000
#0462:000000

#0471:000000
#0472:000000

#0481:000000
#0482:000000

#0491:000000
#0492:000000

#0501:000000
#0502:000000

#0511:101000
#0512:010000

#0521:000000
#0522:000000

#0531:011000
#0532:100000

#0541:000000
#0542:000000

#0551:800100
#0552:091000

#0561:000000
#0562:000000

#0571:092000
#0572:800000

#0581:000000
#0582:000000

#0591:010100
#0592:101010
#PATEND